||||||||||||||||||||||||||||
|   |   | ||||||||| ||| ||||
||  |  ||   |   |    |   |||
|  |  |||     |        |  ||
| ||          |       ||   |
|   ||||||||  |  |||||||   |
|             |            |
||      | |||   |||   | |  |
|||    |  |  |X|  |    |   |
||||  |   |   |   |   | |  |
|||    |            |      |
||      |          |||     |
|        |          |  ||| |
||||||||||||     |    |||| |
||||||||    |   |     |    |
||||           |      || |||
||||||||||||||||||||||||||||
