||||||||||||||||||||||||||||
|                          |
|                          |
|                          |
|                          |
|                          |
|                          |
|                          |
|             X            |
|                          |
|                          |
|                          |
|                          |
|                          |
|                          |
|                          |
||||||||||||||||||||||||||||
